0,0,0,0,0,0,0
0,0,0,0,0,0,0
0,0,0,0,0,0,0
0,0,8,0,0,0,0
-1,0,0,8,0,0,-2
1,11,11,11,11,11,11
1,0,0,0,0,0,0
1,0,0,0,0,0,8