0,	11,	0,	0,	0,	0,	0,
0,	1,	0,	0,	0,	1,	1,
-2,	1,	0,	0,	0,	11,	8,
1,	1,	0,	0,	0,	1,	1,
8,	11,	0,	0,	0,	0,	0,
1,	0,	0,	0,	0,	0,	8,
-1,	0,	0,	0,	0,	0,	0,
1,	1,	1,	1,	1,	1,	1,