0,	0,	1,	0,	0,	1,	8,
-2,	8,	1,	0,	0,	0,	0,
0,	0,	11,	0,	1,	0,	0,
0,	2,	2,	2,	1,	11,	11,
8,	1,	1,	1,	1,	0,	0,
0,	1,	0,	0,	0,	11,	0,
11,	1,	0,	0,	0,	0,	1,
-1,	11,	0,	0,	0,	11,	0,